TILEMAP
36 28 							-- Size of tile map in tiles
16 32 							-- Tile size & block size
images/blocks.png 	-- Tilesheet
2 2								-- Number of tiles in tilesheet
333333333333333333333333333333333333
333333333333333333333333333333333333
333333333333333333333333333333333333
333333333333333333333333333333333333
333333333333333333333333333333333333
333333333333333333333333333333333333
333333333333333333333333333333333333
333333333333333333333333333333333333
33                         3        
33                         3        
33                         3        
33                                  
33        9                         
33    338333333333333833      338333
33      8            8          8 33
33      8            8          8 33
33      8            8          8 33
33      8            8          8 33
33                           a    33
333333333333333333333333333333333333
333333333333333333333333333333333333
333333333333333333333333333333333333
333333333333333333333333333333333333
333333333333333333333333333333333333
333333333333333333333333333333333333
333333333333333333333333333333333333
333333333333333333333333333333333333
333333333333333333333333333333333333


