TILEMAP
36 28 							-- Size of tile map in tiles
16 32 							-- Tile size & block size
images/blocks.png 	-- Tilesheet
2 2								-- Number of tiles in tilesheet
333333333333333333333333333333333333
333333333333333333333333333333333333
333333333333333333333333333333333333
333333333333333333333333333333333333
333333333333333333333333333333333333
333333333333333333333333333333333333
333333333333333333333333333333333333
333333333333333333333333333333333333
33                         3        
33                         3        
33                         3        
33                                  
33                                  
33    339333333333333933      339333
33      9            9          9 33
33      9            9          9 33
33      9            9          9 33
33      9            9          9 33
33  b                        a    33
333333333333333333333333333333333333
333333333333333333333333333333333333
333333333333333333333333333333333333
333333333333333333333333333333333333
333333333333333333333333333333333333
333333333333333333333333333333333333
333333333333333333333333333333333333
333333333333333333333333333333333333
333333333333333333333333333333333333


